##################################
=======####################=======
==================================
     MM====================MM     
      M====================M      
#####  ====================  #####
#####  ====================  #####
#####  ====================  #####
#####           MM           #####
#####           MM           #####