==============##
==============##
==============##
              ##
##            ##
##    ====    MM
##            ##
##            ##
##            ##
##            ##
##    ====    MM
##            ##
##            ##
##            ##
==            ##
==    ====    MM
==            ##
              ##