# #################
# #################
  MMMMMMM=MMMMMMM  
  MMMMMMM=MMMMMMM  
         =         
     #########     
####           ####
                   
                   
                   
                   
################ ##
################ ##
################ ##
################ ##